NO textures/no.xpm
SO textures/so.xpm
WE textures/we.xpm
EA textures/ea.xpm

F 128,128,128
C 0,0,75

111111111111111111111111111111111
111111111000000000110000000000001
111111111011000001110000000000001
1111111110010000E0000000000000001
1111111110110000011100000000000001
100000000011000001110111100011111
111101111111110111000000100011111
111101111111110111010100100011111
110000001101010111000000100011111
100000000000000011000000100011111
100000000000000011010100100011111
110000011101010111110111100011111
111101111111010111011110100011111
111111111111111111111111111111111